ID: jvjgia37	Search: concert-this madonna

ID: jvjh6o0k	Search: inquirer 

ID: jvjhbrdt	Search: spotify-this-song 

ID: jvjhcjyz	Search: spotify-this-song 

ID: jvjhd5ri	Search: spotify-this-song sound of silence

ID: jvjhdthf	Search: spotify-this-song 

ID: jvjhf5a1	Search: concert-this luke bryant

ID: jvjhf85l	Search: concert-this luke bryan

ID: jvjhffkg	Search: concert-this luke bryan

ID: jvjhguuo	Search: movie-this 

ID: jvjhh0g3	Search: movie-this terminator

ID: jvjhh3b8	Search: movie-this terminator

ID: jvjhh7bk	Search: movie-this 

ID: jvjhh8x9	Search: movie-this terminator

ID: jvji7dut	Search: inquirer 

ID: jvji7oil	Search: inquirer 

ID: jvjikkci	Search: concert-this madonna

ID: jvjilia8	Search: concert-this madonna

ID: jvjilp7s	Search: movie-this 

ID: jvjilwsd	Search: movie-this gone with the wind

ID: jvjimhv9	Search: spotify-this-song 

ID: jvjimnto	Search: spotify-this-song halo

ID: jvjin3no	Search: inquirer 

ID: jvjinf3i	Search: inquirer 

ID: jvjinkwd	Search: inquirer 

ID: jvjinvot	Search: inquirer 

